0000110000010100000110000
0000110000010100000110000
0000110000010100000110000
0000110000010100000110000
0000000000010100000000000
0000000000010100000000000
0000000000010100000000000
0000000000010100000000000
0000110000000000000110000
0000110000000000000110000
0000110000000000000110000
0000110000010100000110000
0000000000001000000000000
0000110000010100000110000
0000110000000000000110000
0000110000000000000110000
0000110000000000000110000
0000000000010100000000000
0000000000010100000000000
0000000000010100000000000
0000000000010100000000000
0000110000010100000110000
0000110000010100000110000
0000110000010100000110000
0000110000001100000110000