0000001100000000011110000
0000110000000000000011000
0111000000000011000001100
0110000000110000011000110
0001100000011100000011100
0000011000000111000000000
0000000110000000011000000
0000000001100000000010000
0000000000011100000000110
0000000000000011110000000
0000000000000000000100000
0000000000000000000001100
0000000000000000000000000
0011000000000000000000000
0000010000000000000000000
0000000111100000000000000
0110000000011100000000000
0000100000000011000000000
0000000110000000110000000
0000000000111000001100000
0011100000001110000011000
0110001100000011000000110
0011000011000000000001110
0001100000000000000110000
0000111100000000011000000