0000001000000000001000000
0000010001010101000100000
0000100010101010100010000
0001000101010101010001000
0010001010101010101000100
0100010101010101010100010
1000101010101010101010001
0001010101010101010101000
1000101010101010101010001
0100010101010101010100010
0010001010101010101000100
0001000101010101010001000
0000100010101010100010000
0001000101010101010001000
0010001010101010101000100
0100010101010101010100010
1000101010101010101010001
0001010101010101010101000
1000101010101010101010001
0100010101010101010100010
0010001010101010101000100
0001000101010101010001000
0000100010101010100010000
0000010001010101000100000
0000001000000000001000000