0011111111111111111111100
0001110000000000000111000
0000000000000000000000000
0000000000011100000000000
0011111111111111111111100
0000000000011100000000000
0000000000000000000000000
0001110000000000000111000
0011111111111111111111100
0001110000000000000111000
0000000000001000000000000
0000000000010100000000000
0000000000100010000000000
0000000000010100000000000
0000000000001000000000000
0001110000000000000011000
0011111111111111111111100
0001110000000000000111000
0000000000000000000000000
0000000000011100000000000
0011111111111111111111110
0000000000011100000000000
0000000000000000000000000
0001110000000000000011000
0011111111111111111111100