1010101010101010101010101
0101010101010101010101010
1010101010101010101010101
0101010101010101010101010
1010101010101010101010101
0101010101010101010101010
1010101010101010101010101
0101010101010101010101010
1010101010101010101010101
0101010101010101010101010
0010101010101010101010100
0001010101010101010101000
0000101010101010101010000
0001010101010101010101000
0010101010101010101010100
0101010101010101010101010
1010101010101010101010101
0101010101010101010101010
1010101010101010101010101
0101010101010101010101010
1010101010101010101010101
0101010101010101010101010
1010101010101010101010101
0101010101010101010101010
1010101010101010101010101