0000011000001100000110000
0000011000001100000110000
0000011000001100000110000
0000011000001100000110000
0000000000001100000000000
0000000000001100000000000
0000000000001100000000000
0000000000001100000000000
0000110000000000000110000
0000110000000000000110000
0000110000000000000110000
0000110000001100000110000
0000000000001100000000000
0000110000001100000110000
0000110000000000000110000
0000110000000000000110000
0000110000000000000110000
0000000000001100000000000
0000000000001100000000000
0000000000001100000000000
0000000000001100000000000
0000110000001100000110000
0000110000001100000110000
0000110000001100000110000
0000110000001100000110000