0000000000011100000000000
0000000001111111000000000
0000000111111111110000000
0000011111111111111100000
0000000111111111110000000
0000000001111111000000000
0000011000011100001100000
0001111110000000111111000
0000011000011100001100000
0000000001111111000000000
0000000111111111110000000
0000011111111111111100000
0001111111111111111111000
0000011111111111111100000
0000000111111111110000000
0000000001111111000000000
0000011000011100001100000
0001111110000000111111000
0000011000011100001100000
0000000001111111000000000
0000000111111111110000000
0000011111111111111100000
0000000111111111110000000
0000000001111111000000000
0000000000011100000000000