0000111111111111111100000
0000000000000000000000000
0000000000000000000000000
0000000000011100000000000
1111111111111111111111111
0000000000011100000000000
0000000000000000000000000
0111000000000000000001110
1111111111111111111111111
0111000000000000000001110
0000000000001000000000000
0000000000010100000000000
0000000000100010000000000
0000000000010100000000000
0000000000001000000000000
0111000000000000000001110
1111111111111111111111111
0111000000000000000001110
0000000000000000000000000
0000000000011100000000000
1111111111111111111111111
0000000000011100000000000
0000000000000000000000000
0111000000000000000001110
1111111111111111111111111