0000000000011100000000000
0000000001110111000000000
0000000111110111110000000
0000011100000000011100000
0000000111110111110000000
0000000001110111000000000
0000000000011100000000000
0000000000000000000000000
0000000000011100000000000
0000000001110111000000000
0000000111110111110000000
0000011111110111111100000
0001110000000000000111000
0000011111110111111100000
0000000111110111110000000
0000000001110111000000000
0000000000011100000000000
0000000000000000000000000
0000000000011100000000000
0000000001110111000000000
0000000111110111110000000
0000011100000000011100000
0000000111110111110000000
0000000001110111000000000
0000000000011100000000000