0011111111111111111111100
0001000000000000000001000
0000100100000000010010000
0100010010000000100100000
0010001001000001001000100
0001000100100010010001000
0000100010010100100010000
0000010001001001000100100
0010001000100010001001000
0001000100010100010010000
0000100010001000100100000
0000010001010101001000000
0000001000100010010000000
0000010001010101001000000
0000100010001000100100000
0001000100010100010010000
0010001000100010001001000
0000010001001001000100100
0000100010010100100010000
0001000100100010010001000
0010001001000001001000100
0000010010000000100100000
0000100100000000010010000
0001000000000000000001000
0011111111111111111111100