0000000111111111110000000
0000001100000000011000000
0000011000000000001100000
0000110000000000000110000
0001100000000000000011000
0011000000000000000001100
0110000000000000000000110
0000000000000000000000000
0110000000000000000000110
0011000000000000000001100
0001100000000000000011000
0000111111111111111110000
0000111111111111111110000
0001100000000000000011000
0011000000000000000001100
0110000000000000000000110
0000000000000000000000000
0110000000000000000000110
0011000000000000000001100
0001100000000000000011000
0000110000000000000110000
0000011000000000001100000
0000001100000000011000000
0000000110000000110000000
0000000011111111100000000